allariz	Allariz:1	Allariz_(Orense):1	
allativo	Caso_allativo:1	
allauca	Alejandro_Núñez_Allauca:1	
allawi	Iyad_Allawi:1	
allback	Marcus_Allback:1	
allbutt	Thomas_Clifford_Allbutt:1	
allbäck	Marcus_Allbäck:1	
alle	San_Carlo_alle_Quattro_Fontane:1	
alleganiensis	Cryptobranchus_alleganiensis:1	
allegany	Condado_de_Allegany_(Maryland):1	
alleghenia	(457)_Alleghenia:1	
allegre	Raul_Allegre:1	
allegret	Marc_Allegret:1	
allegri	Antonio_Allegri_da_Correggio:1	Gregorio_Allegri:1	
allegro	Allegro:1	Yves_Allegro:10	Allegro_(biblioteca_de_programación):9	Allegro_(música):5	
alleluia	Alleluia:1	
alleluiaticum	Alleluiaticum:1	
allely	José_María_Allely_Núñez:1	
allemande	Allemande:1	
allemansrätten	Allemansrätten:1	
allen	Thomas_Allen:1	Lily_Allen:1	Cinturones_de_Van_Allen:11	Allen_Karr:3	Russell_Allen:1	Allen_Jenkins:7	Robert_Allen_Zimmerman:1	Llave_Allen:2	Tony_Allen_(basketball):1	Tyrees_Allen:1	Allen_(Capítulo_de_Prison_Break):1	Llaves_allen:1	Woody_Allen:1	Les_Allen:1	Joel_Asaph_Allen:1	Bart_Allen:1	Geri_Allen:1	Cinturones_de_van_Allen:1	Tim_Allen:1	Regla_de_Allen:1	Allen_Carr:1	Paul_Allen:1	Stuart_Allen_Roosa:1	Grant_Allen:1	James_Van_Allen:1	Robert_Allen_Rolfe:1	Rick_Allen:1	Allen_Dulles:1	Karen_Allen:1	Allen_Ginsberg:1	Allen_Welsh_Dulles:1	John_Allen_Paulos:1	Allen_Stewart_Konigsberg:1	Allen_Iverson:1	Allen:1	Joan_Allen:1	Allen_Johnson:1	Irwin_Allen:1	James_Alfred_van_Allen:1	Allen_Newell:1	
allende	Nacho_Allende:1	Valle_de_Allende:1	Allende_(Coahuila):1	Isabel_Allende_Llona:1	Tula_de_Allende:1	Allende_(Estación):1	Isabel_Allende_Bussi:1	Allende:1	Pedro_Humberto_Allende_Sarón:1	Ignacio_Allende_(Zacatecas):1	Ramón_Allende_Padín:1	Ignacio_María_de_Allende:1	Infancia_y_adolescencia_de_Salvador_Allende:1	Allende_(Nuevo_León):1	Bárbara_Allende_Gil_de_Biedma:1	Isabel_Allende_(desambiguación):1	Pueblito_de_Allende:1	Salvador_Allende:1	Allende_(Municipio_de_Guanajuato):1	Juan_Rafael_Allende:1	San_Miguel_de_Allende_(Guanajuato):1	Simojovel_de_Allende:1	San_Miguel_de_Allende:1	San_Miguel_de_Allende_(ciudad,_Guanajuato):1	Talpa_de_Allende:1	Eduardo_Arbide_Allende:1	ARM_Allende:1	Allende_(Municipio_de_Chihuahua):1	Salvador_Allende_Gossens:1	Allende_el_Río:1	Ignacio_Allende:1	Allende_(Guanajuato):1	Juan_Martin_Allende:1	Isabel_Allende:1	
allender	Paul_Allender:1	
allendesalazar	Manuel_Allendesalazar_Muñoz:1	Allendesalazar:3	Manuel_Allendesalazar:1	
allendista	Movimiento_de_Izquierda_Democrática_Allendista:1	
allenwiller	Allenwiller:1